XXXXXXXXXXXXXXXXXXXX
X111111111111111111X
X113111111211111111X
X111111111111111111X
X111112111111111111X
X111111111131111111X
X131111111 11111111X
X11111111 P 1111111X
X111111111 11112111X
XXXXXXXXXXXXXXXXXXXX