XXXXXXXXXXXXXXXXXXXX
XXXXXXXXXXXXXXXXXXXX
XXXXXXXXXXXXXXXXXXXX
X                  L
X XXXXXXXXXXXXXXX  X
X            XXXXX X
X X     X    XPXXX X
X  X X X   XXX XX  X
X   X X    R       X
XXXXXXXXXXXXXXXXXXUX